---#--###--#-
-#---#----##-
####-#-#-#-##
---#---#-#---
-#-####---##-
-#------#---@
-############
-------------