---#--###----
-#---#----# -
####-#-#-#-##
---#---#-#---
-#-####---##-
-#------#----
-############
------------@