---#--###----
-#---#----#--
####-#-#-#-##
---#---#-#---
-#-####---##-
-#------#----
-############
------------@