---#--###----
-#---#----##-
####-#-#-#-##
---#---#-#---
-#-####---##-
-#------#----
-############
-------------
---#--###----
-#---#----##-
####-#-#-#-##
---#---#-#---
-#-####---##-
-#------#----
-############
-------------
-#---#----##-
####-#-#-#-##
---#---#-#---
-#-####---##-
-#------#----
-############
-------------
-#---#----##-
####-#-#-#-##
---#---#-#---
-#-####---##-
-#------#----
-############
-------------
-#---#----##-
####-#-#-#-##
---#---#-#---
-#-####---##-
-#------#----
-############
-------------
-#---#----##-
####-#-#-#-##
---#---#-#---
-#-####---##-
-#------#----
-############
-------------
-#---#----##-
####-#-#-#-##
---#---#-#---
-#-####---##-
-#------#----
-############
-------------
-#---#----##-
####-#-#-#-##
---#---#-#---
-#-####---##-
-#------#----
-############
---#--###----
-#---#----##-
####-#-#-#-##
---#---#-#---
-#-####---##-
-#------#----
-############
-------------
---#--###----
-#---#----##-
####-#-#-#-##
---#---#-#---
-#-####---##-
-#------#----
-############
-------------
-#---#----##-
####-#-#-#-##
---#---#-#---
-#-####---##-
-#------#----
-############
-------------
-#---#----##-
####-#-#-#-##
---#---#-#---
-#-####---##-
-#------#----
-############
-------------
-#---#----##-
####-#-#-#-##
---#---#-#---
-#-####---##-
-#------#----
-############
-------------
-#---#----##-
####-#-#-#-##
---#---#-#---
---#--###----
-#---#----##-
####-#-#-#-##
---#---#-#---
-#-####---##-
-#------#----
-############
-------------
---#--###----
-#---#----##-
####-#-#-#-##
---#---#-#---
-#-####---##-
-#------#----
-############
-------------
-#---#----##-
####-#-#-#-##
---#---#-#---
-#-####---##-
-#------#----
-############
-------------
-#---#----##-
####-#-#-#-##
---#---#-#---
-#-####---##-
-#------#----
-############
-------------
-#---#----##-
####-#-#-#-##
---#---#-#---
-#-####---##-
-#------#----
-############
-------------
-#---#----##-
####-#-#-#-##
---#---#-#---
-#-####---##-
-#------#----
-############
-------------
-#---#----##-
####-#-#-#-##
---#---#-#---
-#-####---##-
-#------#----
-############
-------------
-#---#----##-
####-#-#-#-##
---#---#-#---
-#-####---##-
-#------#----
-############
---#--###----
-#---#----##-
####-#-#-#-##
---#---#-#---
-#-####---##-
-#------#----
-############
-------------
---#--###----
-#---#----##-
####-#-#-#-##
---#---#-#---
-#-####---##-
-#------#----
-############
-------------
-#---#----##-
####-#-#-#-##
---#---#-#---
-#-####---##-
-#------#----
-############
-------------
-#---#----##-
####-#-#-#-##
---#---#-#---
-#-####---##-
-#------#----
-############
-------------
-#---#----##-
####-#-#-#-##
---#---#-#---
-#-####---##-
-#------#----
-############
-------------
-#---#----##-
####-#-#-#-##
---#---#-#---
---#--###----
-#---#----##-
####-#-#-#-##
---#---#-#---
-#-####---##-
-#------#----
-############
-------------
---#--###----
-#---#----##-
####-#-#-#-##
---#---#-#---
-#-####---##-
-#------#----
-############
-------------
-#---#----##-
####-#-#-#-##
---#---#-#---
-#-####---##-
-#------#----
-############
-------------
-#---#----##-
####-#-#-#-##
---#---#-#---
-#-####---##-
-#------#----
-############
-------------
-#---#----##-
####-#-#-#-##
---#---#-#---
-#-####---##-
-#------#----
-############
-------------
-#---#----##-
####-#-#-#-##
---#---#-#---
-#-####---##-
-#------#----
-############
-------------
-#---#----##-
####-#-#-#-##
---#---#-#---
-#-####---##-
-#------#----
-############
-------------
-#---#----##-
####-#-#-#-##
---#---#-#---
-#-####---##-
-#------#----
-############
---#--###----
-#---#----##-
####-#-#-#-##
---#---#-#---
-#-####---##-
-#------#----
-############
-------------
---#--###----
-#---#----##-
####-#-#-#-##
---#---#-#---
-#-####---##-
-#------#----
-############
-------------
-#---#----##-
####-#-#-#-##
---#---#-#---
-#-####---##-
-#------#----
-############
-------------
-#---#----##-
####-#-#-#-##
---#---#-#---
-#-####---##-
-#------#----
-############
-------------
-#---#----##-
####-#-#-#-##
---#---#-#---
-#-####---##-
-#------#----
-############
-------------
-#---#----##-
####-#-#-#-##
---#---#-#--@