-#-
---
--@

+++#--###----
!#+++#+++-##-
####+#+#+#-##
+++#+++#+#---
+#+####++-##-
+#++++++#----
+############
++++++++++++@