---#--###--#----#--###--#-
-#---#----##----#--###--#-
####-#-#-#-##---#--###--#-
---#---#-#------#--###--#-
-#-####---##----#--###--#-
-#------#-------#--###--#-
-############---#--###--#-
----------------#--###--#-
---#--###--#----#--###--#-
-#---#----##----#--###--#-
####-#-#-#-##---#--###--#-
---#---#-#------#--###--#-
-#-####---##----#--###--#-
-#------#-------#--###--#-
-############---#--###--#-
---------------@#--###--#-